R 	1280 720
NO ./textures/wall_1.xpm
SO ./textures/wall_0.xpm


WE ./textures/wall_2.xpm

EA ./textures/wall_3.xpm
	S ./textures/charactersprite.xpm
SA 10 5 ./textures/sprite_gif/frame_0.xpm
F 122 , 39  ,  95
C 125,120,255
                                       11111111111111111111111111
                                       10200200200000222222222201
                                       10200200200000222222222201
                                       10200200200000222222222201
        1111111111111111111111111      1020020020000022222222220111111111
       1000000000011000000000000111111111111111111000111111111110000000001
  11111 111111100000111000000200000000000000000000000000000W000000000000211
  10021      100100000000000000000000000000000100001000000010001000010000001
  11111     1000001110000000000000000000000000000000000000000000000000000001
           1000001110111110111111111111111111111111111111111110000000000011
111111111111110111000000100011                               100000000011
11110111111111011101010010001111111111111111111111            100000001
11000000110101011100000010000000000000000000000001             1000001
12222222222222221100000010001111111111111111111111              10001
12222222222222220101011110011                                    101
1122211111212121110100000111                                      1
11112111 1112121 101111010001
11111111 1111111 111111111111
