R 	1280 720 
NO ./textures/wall_1.xpm
SO ./textures/wall_0.xpm


WE ./textures/wall_2.xpm

EA ./textures/wall_3.xpm
	S ./textures/charactersprite.xpm
SA 31 1 ./textures/suicune/frame_00.xpm
F 102, 0, 204 
C 51, 204, 255


11111111111111111111111111111111111111
12222222222222222222222222222222222221
12222222222222222222222222222222222221
12222222222222222222222222222222222221
12222222222222222222222222222222222221
12222222222222222222222222222222222221
12222222222222222222222222222222222221
12222222222222222222222222222222222221
12222222222222222222222222222222222221
12222222222222222222222222222222222221
12222222222222222222222222222222222221
12222222222222222222222222222222222221
12222222222222222222222222222222222221
1222222222222222N222222222222222222221
12222222222222222222222222222222222221
12222222222222222222222222222222222221
12222222222222222222222222222222222221
12222222222222222222222222222222222221
12222222222222222222222222222222222221
12222222222222222222222222222222222221
12222222222222222222222222222222222221
12222222222222222222222222222222222221
12222222222222222222222222222222222221
12222222222222222222222222222222222221
12222222222222222222222222222222222221
12222222222222222222222222222222222221
12222222222222222222222222222222222221
12222222222222222222222222222222222221
11111111111111111111111111111111111111
